1111111111111111111111111
1111111111111111111111111
1111111111111111111111111
11111111111111C1111111111
1111111111111PCE111111111
11111111111111C1111111111
1111111111111111111111111
1111111111111111111111111